# # # # # # # # # #
# G G G G R G G G #
# G F F R R F M G #
# G F W G G G M G #
# G R R M M R G G #
# G W W W G G G G #
# G G R R G F F G #
# G G M G G M R G #
# G G G G R G G G #
# # # # # # # # # #
